
NO ../assets/images/no_redbrick.xpm
SO ../assets/images/so_redbrick.xpm
EA ../assets/images/ea_redbrick.xpm
WE ../assets/images/we_redbrick.xpm
C 255,200,                                                      160
F                                       122         ,           122             ,           122

11111111111111111
10000000000000001
10000000000000001
10000000000000001
10000000000000001
10000000000000001
10000000N00000001
10000000000000001
10000000000000001
10000000000000001
10000000000000001
10000000000000001
11111111111111111
