NO ./.xpm/no_redbrick.xpm
SO ./.xpm/so_redbrick.xpm
EA ./.xpm/ea_redbrick.xpm
WE ./.xpm/we_redbrick.xpm
C 255,200,160
F 122,122,122

        1
11111111N11111111
10000000000000001
10000000000000001
10000000000000001
10000000000000001
10000000000000001
10000000000000001
10000000000000001
10000000000000001
10000000000000001
10000000000000001
10000000000000001
11111111111111111
